//MAP CONVERTED BY dmm2tgm.py THIS HEADER COMMENT PREVENTS RECONVERSION, DO NOT REMOVE
"e" = (
/turf/open/floor/mineral/titanium/blue,
/area/shuttle/supply)
"f" = (
/obj/machinery/conveyor{
	dir = 4;
	id = "QMLoad2"
	},
/obj/machinery/door/poddoor{
	id = "QMLoaddoor2";
	name = "supply dock loading door"
	},
/turf/open/floor/plating,
/area/shuttle/supply)
"g" = (
/obj/machinery/door/airlock/titanium{
	name = "Supply Shuttle Airlock";
	req_access_txt = "31"
	},
/turf/open/floor/plating,
/area/shuttle/supply)
"h" = (
/obj/machinery/button/door/directional/east{
	id = "QMLoaddoor2";
	name = "Loading Doors";
	pixel_y = 8
	},
/obj/machinery/button/door/directional/east{
	id = "QMLoaddoor";
	name = "Loading Doors";
	pixel_y = -8
	},
/obj/machinery/light/directional/east,
/turf/open/floor/mineral/titanium/blue,
/area/shuttle/supply)
"i" = (
/obj/machinery/door/airlock/titanium{
	name = "Supply Shuttle Airlock";
	req_access_txt = "31"
	},
/obj/docking_port/mobile/supply,
/turf/open/floor/plating,
/area/shuttle/supply)
"j" = (
/obj/machinery/conveyor{
	dir = 8;
	id = "QMLoad"
	},
/obj/machinery/door/poddoor{
	id = "QMLoaddoor";
	name = "supply dock loading door"
	},
/turf/open/floor/plating,
/area/shuttle/supply)
"l" = (
/turf/closed/wall/mineral/titanium/shuttle,
/area/shuttle/supply)
"q" = (
/obj/structure/window/reinforced{
	dir = 1
	},
/obj/structure/shuttle/engine/heater,
/turf/open/floor/plating/airless,
/area/shuttle/supply)
"s" = (
/turf/template_noop,
/area/template_noop)
"t" = (
/obj/structure/shuttle/engine/propulsion/burst/left,
/turf/open/floor/plating/airless,
/area/shuttle/supply)
"u" = (
/obj/structure/shuttle/engine/propulsion,
/turf/open/floor/plating/airless,
/area/shuttle/supply)
"v" = (
/obj/structure/shuttle/engine/propulsion/burst/right,
/turf/open/floor/plating/airless,
/area/shuttle/supply)
"w" = (
/obj/machinery/light/directional/north,
/turf/open/floor/mineral/titanium/blue,
/area/shuttle/supply)
"x" = (
/obj/machinery/light/directional/west,
/turf/open/floor/mineral/titanium/blue,
/area/shuttle/supply)

(1,1,1) = {"
l
l
l
l
l
l
l
l
l
l
l
s
"}
(2,1,1) = {"
l
e
e
e
e
x
e
e
e
l
l
t
"}
(3,1,1) = {"
l
e
e
e
e
e
e
e
e
e
q
u
"}
(4,1,1) = {"
l
w
e
e
e
e
e
e
e
e
q
u
"}
(5,1,1) = {"
l
e
e
e
e
e
e
e
e
e
q
u
"}
(6,1,1) = {"
l
e
e
e
e
h
e
e
e
l
l
v
"}
(7,1,1) = {"
l
l
l
f
g
l
i
j
l
l
l
s
"}
