//MAP CONVERTED BY dmm2tgm.py THIS HEADER COMMENT PREVENTS RECONVERSION, DO NOT REMOVE
"aa" = (
/turf/template_noop,
/area/template_noop)
"ae" = (
/obj/machinery/door/airlock/titanium{
	name = "Emergency Shuttle Airlock"
	},
/turf/open/floor/mineral/titanium/yellow,
/area/shuttle/escape)
"ah" = (
/obj/effect/spawner/structure/window/reinforced/shuttle,
/turf/open/floor/plating,
/area/shuttle/escape)
"ai" = (
/obj/machinery/door/airlock/titanium{
	name = "Emergency Shuttle Airlock"
	},
/turf/open/floor/mineral/titanium,
/area/shuttle/escape)
"aj" = (
/obj/machinery/door/airlock/titanium{
	name = "Emergency Shuttle Airlock"
	},
/obj/docking_port/mobile/emergency{
	dir = 2;
	dwidth = 10;
	height = 13;
	name = "Asteroid emergency shuttle";
	width = 28
	},
/turf/open/floor/mineral/titanium,
/area/shuttle/escape)
"al" = (
/obj/machinery/door/airlock/titanium{
	name = "Emergency Shuttle Airlock"
	},
/obj/effect/mapping_helpers/airlock/access/all/security/brig,
/turf/open/floor/mineral/plastitanium/red/brig,
/area/shuttle/escape/brig)
"am" = (
/obj/structure/shuttle/engine/propulsion{
	dir = 8
	},
/turf/open/floor/plating/airless,
/area/shuttle/escape)
"an" = (
/obj/structure/shuttle/engine/heater{
	dir = 8
	},
/turf/open/floor/plating/airless,
/area/shuttle/escape)
"ap" = (
/obj/structure/ore_box,
/turf/open/floor/mineral/titanium/yellow,
/area/shuttle/escape)
"aq" = (
/turf/open/floor/mineral/titanium/yellow,
/area/shuttle/escape)
"ar" = (
/obj/machinery/recharge_station,
/turf/open/floor/mineral/titanium/yellow,
/area/shuttle/escape)
"at" = (
/turf/open/floor/mineral/titanium,
/area/shuttle/escape)
"av" = (
/obj/structure/chair/comfy/shuttle{
	dir = 4
	},
/turf/open/floor/mineral/plastitanium/red/brig,
/area/shuttle/escape/brig)
"aw" = (
/turf/open/floor/mineral/plastitanium/red/brig,
/area/shuttle/escape/brig)
"ax" = (
/obj/structure/chair/comfy/shuttle{
	dir = 8
	},
/turf/open/floor/mineral/plastitanium/red/brig,
/area/shuttle/escape/brig)
"az" = (
/turf/closed/wall/mineral/titanium/shuttle,
/area/shuttle/escape)
"aE" = (
/obj/structure/chair/comfy/shuttle{
	dir = 4
	},
/obj/item/radio/intercom/directional/west,
/turf/open/floor/mineral/plastitanium/red/brig,
/area/shuttle/escape/brig)
"aF" = (
/obj/machinery/suit_storage_unit,
/turf/open/floor/mineral/titanium/yellow,
/area/shuttle/escape)
"aG" = (
/obj/machinery/door/airlock/mining{
	name = "Emergency Shuttle Storage"
	},
/turf/open/floor/mineral/titanium/yellow,
/area/shuttle/escape)
"aH" = (
/obj/structure/extinguisher_cabinet/directional/north,
/turf/open/floor/mineral/titanium,
/area/shuttle/escape)
"aI" = (
/obj/structure/closet,
/turf/open/floor/mineral/titanium/blue,
/area/shuttle/escape)
"aJ" = (
/obj/structure/table,
/obj/item/extinguisher,
/obj/item/crowbar,
/turf/open/floor/mineral/titanium/blue,
/area/shuttle/escape)
"aK" = (
/obj/structure/chair/comfy/shuttle,
/turf/open/floor/mineral/titanium/blue,
/area/shuttle/escape)
"aL" = (
/obj/structure/table,
/obj/item/storage/medkit/fire,
/obj/item/storage/medkit/regular{
	pixel_x = 2;
	pixel_y = 3
	},
/turf/open/floor/mineral/titanium/blue,
/area/shuttle/escape)
"aM" = (
/obj/structure/closet/emcloset,
/obj/item/radio/intercom/directional/north,
/turf/open/floor/mineral/titanium/blue,
/area/shuttle/escape)
"aN" = (
/obj/structure/bed/roller,
/turf/open/floor/mineral/titanium/blue,
/area/shuttle/escape)
"aP" = (
/obj/machinery/door/airlock/security/glass{
	name = "Emergency Shuttle Brig"
	},
/obj/effect/mapping_helpers/airlock/access/all/security/brig,
/turf/open/floor/mineral/plastitanium/red/brig,
/area/shuttle/escape/brig)
"aQ" = (
/obj/structure/bed,
/turf/open/floor/mineral/plastitanium/red/brig,
/area/shuttle/escape/brig)
"aR" = (
/obj/machinery/computer/station_alert{
	dir = 4
	},
/turf/open/floor/mineral/titanium/blue,
/area/shuttle/escape)
"aS" = (
/turf/open/floor/mineral/titanium/blue,
/area/shuttle/escape)
"aT" = (
/obj/structure/chair/office/light{
	name = "Chief Engineer"
	},
/turf/open/floor/mineral/titanium/blue,
/area/shuttle/escape)
"aU" = (
/obj/structure/chair/office/light{
	name = "Captain"
	},
/obj/machinery/light/directional/north,
/turf/open/floor/mineral/titanium/blue,
/area/shuttle/escape)
"aV" = (
/obj/structure/chair/office/light{
	name = "Head of Security"
	},
/turf/open/floor/mineral/titanium/blue,
/area/shuttle/escape)
"aW" = (
/obj/item/radio/intercom/directional/north,
/turf/open/floor/mineral/titanium,
/area/shuttle/escape)
"aY" = (
/obj/structure/chair/comfy/shuttle{
	dir = 8
	},
/turf/open/floor/mineral/titanium/blue,
/area/shuttle/escape)
"aZ" = (
/obj/structure/chair/comfy/shuttle{
	dir = 1
	},
/turf/open/floor/mineral/titanium/blue,
/area/shuttle/escape)
"ba" = (
/obj/structure/chair/comfy/shuttle{
	dir = 4
	},
/turf/open/floor/mineral/titanium/blue,
/area/shuttle/escape)
"bb" = (
/obj/machinery/computer/security{
	dir = 4
	},
/turf/open/floor/mineral/plastitanium/red/brig,
/area/shuttle/escape/brig)
"bc" = (
/obj/structure/table,
/obj/item/paper_bin{
	pixel_x = -1;
	pixel_y = 6
	},
/turf/open/floor/mineral/titanium,
/area/shuttle/escape)
"bd" = (
/obj/machinery/computer/emergency_shuttle,
/turf/open/floor/mineral/titanium,
/area/shuttle/escape)
"be" = (
/obj/structure/table,
/obj/item/folder/blue,
/obj/item/pen,
/obj/machinery/recharger,
/turf/open/floor/mineral/titanium,
/area/shuttle/escape)
"bf" = (
/obj/machinery/ai_slipper,
/turf/open/floor/mineral/titanium,
/area/shuttle/escape)
"bg" = (
/obj/machinery/door/airlock/command/glass{
	name = "Emergency Shuttle Cockpit"
	},
/obj/effect/mapping_helpers/airlock/access/all/command/general,
/turf/open/floor/mineral/titanium,
/area/shuttle/escape)
"bi" = (
/obj/machinery/status_display/evac,
/turf/closed/wall/mineral/titanium/shuttle,
/area/shuttle/escape)
"bj" = (
/obj/machinery/computer/communications{
	dir = 4
	},
/turf/open/floor/mineral/titanium/blue,
/area/shuttle/escape)
"bk" = (
/obj/structure/chair/office/light{
	dir = 1;
	name = "Research Director"
	},
/turf/open/floor/mineral/titanium/blue,
/area/shuttle/escape)
"bl" = (
/obj/structure/chair/office/light{
	dir = 1;
	name = "Head of Personnel"
	},
/turf/open/floor/mineral/titanium/blue,
/area/shuttle/escape)
"bm" = (
/obj/structure/chair/office/light{
	dir = 1;
	name = "Chief Medical Officer"
	},
/turf/open/floor/mineral/titanium/blue,
/area/shuttle/escape)
"bn" = (
/obj/structure/extinguisher_cabinet/directional/south,
/turf/open/floor/mineral/titanium,
/area/shuttle/escape)
"bp" = (
/obj/machinery/computer/crew{
	dir = 4
	},
/turf/open/floor/mineral/titanium/white,
/area/shuttle/escape)
"bq" = (
/obj/machinery/door/airlock/medical/glass{
	name = "Escape Shuttle Infirmary"
	},
/obj/effect/mapping_helpers/airlock/access/all/medical/general,
/turf/open/floor/mineral/titanium/white,
/area/shuttle/escape)
"br" = (
/obj/machinery/door/airlock/medical/glass{
	name = "Escape Shuttle Infirmary"
	},
/turf/open/floor/mineral/titanium/white,
/area/shuttle/escape)
"bs" = (
/obj/structure/bed,
/turf/open/floor/mineral/titanium/white,
/area/shuttle/escape)
"bt" = (
/obj/structure/sink{
	dir = 4;
	pixel_x = -12;
	pixel_y = 2
	},
/obj/structure/mirror/directional/west,
/turf/open/floor/mineral/titanium/white,
/area/shuttle/escape)
"bu" = (
/obj/machinery/door/airlock{
	name = "Emergency Shuttle Restroom"
	},
/turf/open/floor/mineral/titanium/white,
/area/shuttle/escape)
"bv" = (
/obj/structure/closet/emcloset,
/turf/open/floor/mineral/titanium/blue,
/area/shuttle/escape)
"bw" = (
/obj/structure/chair/comfy/shuttle{
	dir = 1
	},
/obj/item/radio/intercom/directional/south,
/turf/open/floor/mineral/titanium/blue,
/area/shuttle/escape)
"bx" = (
/obj/structure/chair/comfy/shuttle{
	dir = 1
	},
/obj/structure/extinguisher_cabinet/directional/south,
/turf/open/floor/mineral/titanium/blue,
/area/shuttle/escape)
"by" = (
/obj/structure/table,
/obj/item/extinguisher,
/obj/item/crowbar,
/obj/machinery/recharger,
/turf/open/floor/mineral/titanium/blue,
/area/shuttle/escape)
"bz" = (
/obj/machinery/stasis,
/obj/machinery/vending/wallmed/directional/east{
	use_power = 0
	},
/turf/open/floor/mineral/titanium/white,
/area/shuttle/escape)
"bC" = (
/obj/item/radio/intercom/directional/west,
/turf/open/floor/mineral/titanium/white,
/area/shuttle/escape)
"bD" = (
/obj/structure/closet/secure_closet/medical2,
/turf/open/floor/mineral/titanium/white,
/area/shuttle/escape)
"bE" = (
/obj/structure/toilet{
	dir = 1
	},
/obj/machinery/light/small/directional/east,
/turf/open/floor/mineral/titanium/white,
/area/shuttle/escape)
"bF" = (
/obj/structure/table,
/obj/item/retractor,
/obj/item/hemostat,
/obj/item/scalpel,
/obj/item/surgicaldrill,
/turf/open/floor/mineral/titanium/white,
/area/shuttle/escape)
"bG" = (
/obj/structure/table/optable,
/turf/open/floor/mineral/titanium/white,
/area/shuttle/escape)
"bH" = (
/obj/structure/table,
/obj/item/circular_saw,
/obj/item/cautery{
	pixel_x = 4
	},
/obj/item/surgical_drapes,
/turf/open/floor/mineral/titanium/white,
/area/shuttle/escape)
"bJ" = (
/obj/machinery/light/directional/south,
/turf/open/floor/mineral/titanium/yellow,
/area/shuttle/escape)
"bK" = (
/obj/structure/chair/comfy/shuttle,
/obj/machinery/light/directional/north,
/turf/open/floor/mineral/titanium/blue,
/area/shuttle/escape)
"bM" = (
/obj/machinery/light/directional/south,
/turf/open/floor/mineral/plastitanium/red/brig,
/area/shuttle/escape/brig)
"bN" = (
/obj/machinery/light/directional/north,
/turf/open/floor/mineral/titanium/white,
/area/shuttle/escape)
"bP" = (
/obj/machinery/light/directional/south,
/turf/open/floor/mineral/titanium/blue,
/area/shuttle/escape)
"hJ" = (
/obj/machinery/status_display/ai/directional/west,
/turf/open/floor/mineral/titanium,
/area/shuttle/escape)
"Id" = (
/obj/machinery/status_display/evac/directional/west,
/turf/open/floor/mineral/titanium,
/area/shuttle/escape)
"Jx" = (
/turf/open/floor/mineral/titanium/white,
/area/shuttle/escape)
"JM" = (
/obj/machinery/vending/wallmed{
	name = "Emergency NanoMed";
	use_power = 0
	},
/turf/closed/wall/mineral/titanium/shuttle,
/area/shuttle/escape)

(1,1,1) = {"
aa
aa
az
am
az
ah
ah
ah
az
am
az
aa
aa
"}
(2,1,1) = {"
az
am
az
an
az
aR
aS
bj
az
an
az
am
az
"}
(3,1,1) = {"
az
an
az
az
az
at
at
at
az
az
az
an
az
"}
(4,1,1) = {"
az
az
az
aF
az
aT
bc
bk
az
bt
az
az
az
"}
(5,1,1) = {"
ah
ap
aq
bJ
az
aU
bd
bl
az
bN
bu
bE
ah
"}
(6,1,1) = {"
ae
aq
aq
aq
az
aV
be
bm
az
Jx
az
az
az
"}
(7,1,1) = {"
ah
ar
aq
aq
az
aW
bf
bn
az
Jx
bu
bE
ah
"}
(8,1,1) = {"
az
az
az
aG
az
az
bg
az
az
bu
az
az
az
"}
(9,1,1) = {"
aa
az
az
aH
at
hJ
at
Id
at
at
az
az
aa
"}
(10,1,1) = {"
aa
aa
az
aI
at
aY
aY
aY
at
bv
az
aa
aa
"}
(11,1,1) = {"
ah
ah
az
aJ
at
aZ
ah
aK
at
aL
az
aa
aa
"}
(12,1,1) = {"
ai
at
at
at
at
aZ
ah
aK
at
bP
az
aa
aa
"}
(13,1,1) = {"
ah
ah
az
bK
at
aZ
ah
aK
at
bw
az
aa
aa
"}
(14,1,1) = {"
aa
aa
ah
aK
at
aZ
ah
aK
at
aZ
ah
aa
aa
"}
(15,1,1) = {"
aa
aa
ah
aK
at
at
at
at
at
aZ
ah
aa
aa
"}
(16,1,1) = {"
aa
aa
ah
aK
at
aZ
ah
aK
at
aZ
ah
aa
aa
"}
(17,1,1) = {"
ah
ah
az
bK
at
aZ
ah
aK
at
bx
az
aa
aa
"}
(18,1,1) = {"
aj
at
at
at
at
aZ
ah
aK
at
bP
az
aa
aa
"}
(19,1,1) = {"
ah
ah
az
aL
at
aZ
ah
aK
at
by
az
aa
aa
"}
(20,1,1) = {"
aa
aa
az
aM
at
ba
ba
ba
at
aI
az
aa
aa
"}
(21,1,1) = {"
aa
az
az
aN
at
at
at
at
at
aN
az
az
aa
"}
(22,1,1) = {"
az
az
az
ah
aP
ah
bi
ah
br
ah
az
az
az
"}
(23,1,1) = {"
az
av
aE
av
aw
bb
az
bp
Jx
Jx
bC
bF
az
"}
(24,1,1) = {"
al
aw
aw
aw
aw
aw
ah
Jx
Jx
Jx
Jx
bG
ah
"}
(25,1,1) = {"
az
ax
ax
ax
aw
bM
az
bN
Jx
bz
bD
bH
az
"}
(26,1,1) = {"
az
az
az
az
ah
aP
az
bq
ah
JM
az
az
az
"}
(27,1,1) = {"
aa
aa
az
az
aQ
aw
ah
Jx
bs
az
az
aa
aa
"}
(28,1,1) = {"
aa
aa
aa
az
az
ah
az
ah
az
az
aa
aa
aa
"}
