//MAP CONVERTED BY dmm2tgm.py THIS HEADER COMMENT PREVENTS RECONVERSION, DO NOT REMOVE
"a" = (
/turf/template_noop,
/area/template_noop)
"b" = (
/obj/structure/shuttle/engine/propulsion{
	dir = 4
	},
/turf/open/floor/plating,
/area/shuttle/escape)
"c" = (
/obj/structure/shuttle/engine/heater{
	dir = 8
	},
/obj/structure/window/reinforced{
	dir = 1
	},
/turf/open/floor/plating,
/area/shuttle/escape)
"f" = (
/obj/machinery/status_display/evac,
/turf/closed/wall/mineral/titanium/shuttle,
/area/shuttle/escape)
"g" = (
/obj/machinery/door/airlock/titanium{
	name = "Emergency Shuttle Airlock"
	},
/turf/open/floor/plating,
/area/shuttle/escape)
"h" = (
/obj/machinery/door/airlock/titanium{
	name = "Emergency Shuttle Airlock"
	},
/obj/docking_port/mobile/emergency{
	dir = 2;
	name = "NES Port";
	width = 19
	},
/turf/open/floor/plating,
/area/shuttle/escape)
"i" = (
/obj/structure/chair/comfy/shuttle{
	dir = 4
	},
/obj/machinery/vending/wallmed/directional/west{
	use_power = 0
	},
/turf/open/floor/mineral/titanium/blue,
/area/shuttle/escape)
"j" = (
/obj/structure/chair/comfy/shuttle{
	dir = 4
	},
/obj/machinery/vending/wallmed/directional/south{
	use_power = 0
	},
/turf/open/floor/mineral/plastitanium/red/brig,
/area/shuttle/escape/brig)
"m" = (
/obj/effect/spawner/structure/window/reinforced/shuttle,
/turf/open/floor/plating,
/area/shuttle/escape)
"n" = (
/turf/open/floor/mineral/titanium/white,
/area/shuttle/escape)
"o" = (
/turf/open/floor/mineral/titanium/blue,
/area/shuttle/escape)
"p" = (
/obj/structure/shuttle/engine/heater{
	dir = 8
	},
/obj/structure/window/reinforced{
	dir = 4
	},
/turf/open/floor/plating,
/area/shuttle/escape)
"q" = (
/obj/machinery/stasis{
	dir = 4
	},
/turf/open/floor/mineral/titanium/white,
/area/shuttle/escape)
"r" = (
/turf/open/floor/mineral/titanium,
/area/shuttle/escape)
"s" = (
/obj/structure/chair/comfy/shuttle{
	dir = 4
	},
/turf/open/floor/mineral/titanium/blue,
/area/shuttle/escape)
"t" = (
/turf/closed/wall/mineral/titanium/shuttle,
/area/shuttle/escape)
"u" = (
/obj/structure/chair/comfy/brown{
	dir = 4
	},
/obj/machinery/light/small/directional/north,
/turf/open/floor/mineral/titanium/yellow,
/area/shuttle/escape)
"v" = (
/obj/structure/table,
/obj/effect/spawner/random/maintenance,
/turf/open/floor/mineral/titanium/white,
/area/shuttle/escape)
"w" = (
/obj/machinery/door/airlock/public/glass{
	name = "Emergency Shuttle Infirmary"
	},
/turf/open/floor/mineral/titanium/white,
/area/shuttle/escape)
"y" = (
/obj/structure/table/reinforced,
/obj/item/storage/toolbox/emergency,
/obj/structure/window/reinforced{
	dir = 1
	},
/turf/open/floor/mineral/titanium/yellow,
/area/shuttle/escape)
"A" = (
/obj/structure/chair/comfy/brown{
	dir = 4
	},
/turf/open/floor/mineral/titanium/yellow,
/area/shuttle/escape)
"B" = (
/obj/structure/window/reinforced{
	dir = 4
	},
/obj/structure/window/reinforced{
	dir = 1
	},
/obj/structure/table/reinforced,
/obj/item/radio,
/turf/open/floor/mineral/titanium/yellow,
/area/shuttle/escape)
"D" = (
/obj/structure/chair/comfy/brown{
	dir = 4
	},
/obj/machinery/light/small/directional/south,
/turf/open/floor/mineral/titanium/yellow,
/area/shuttle/escape)
"E" = (
/obj/machinery/door/airlock/public/glass{
	name = "Emergency Shuttle Cockpit"
	},
/obj/effect/mapping_helpers/airlock/access/all/command/general,
/turf/open/floor/mineral/titanium/yellow,
/area/shuttle/escape)
"F" = (
/turf/open/floor/mineral/titanium/yellow,
/area/shuttle/escape)
"G" = (
/obj/machinery/computer/emergency_shuttle{
	dir = 8
	},
/obj/structure/window/reinforced{
	dir = 4
	},
/turf/open/floor/mineral/titanium/yellow,
/area/shuttle/escape)
"H" = (
/obj/structure/chair/comfy/shuttle{
	dir = 4
	},
/turf/open/floor/mineral/plastitanium/red/brig,
/area/shuttle/escape/brig)
"I" = (
/obj/structure/table/reinforced,
/obj/structure/window/reinforced{
	dir = 4
	},
/obj/structure/window/reinforced,
/obj/item/storage/medkit/regular,
/turf/open/floor/mineral/titanium/yellow,
/area/shuttle/escape)
"J" = (
/turf/open/floor/mineral/plastitanium/red/brig,
/area/shuttle/escape/brig)
"K" = (
/obj/machinery/door/airlock/public/glass{
	name = "Emergency Shuttle Brig"
	},
/obj/effect/mapping_helpers/airlock/access/all/security/brig,
/turf/open/floor/mineral/plastitanium/red/brig,
/area/shuttle/escape/brig)
"L" = (
/obj/structure/table/reinforced,
/obj/item/storage/medkit/regular,
/obj/structure/window/reinforced,
/turf/open/floor/mineral/titanium/yellow,
/area/shuttle/escape)
"Q" = (
/obj/machinery/light/directional/south,
/turf/open/floor/mineral/titanium,
/area/shuttle/escape)
"R" = (
/obj/machinery/light/small/directional/south,
/turf/open/floor/mineral/titanium/white,
/area/shuttle/escape)
"S" = (
/obj/structure/chair/comfy/shuttle{
	dir = 4
	},
/obj/machinery/light/directional/east,
/turf/open/floor/mineral/titanium/blue,
/area/shuttle/escape)
"T" = (
/obj/structure/chair/comfy/shuttle{
	dir = 4
	},
/obj/machinery/light/small/directional/north,
/turf/open/floor/mineral/plastitanium/red/brig,
/area/shuttle/escape/brig)
"V" = (
/obj/machinery/light/directional/north,
/turf/open/floor/mineral/titanium,
/area/shuttle/escape)
"W" = (
/obj/structure/shuttle/engine/propulsion{
	dir = 4
	},
/obj/structure/window/reinforced{
	dir = 1
	},
/turf/open/floor/plating,
/area/shuttle/escape)
"X" = (
/obj/structure/shuttle/engine/propulsion{
	dir = 4
	},
/obj/structure/window/reinforced,
/turf/open/floor/plating,
/area/shuttle/escape)
"Y" = (
/obj/structure/shuttle/engine/heater{
	dir = 8
	},
/obj/structure/window/reinforced,
/turf/open/floor/plating,
/area/shuttle/escape)
"Z" = (
/obj/machinery/vending/wallmed/directional/north{
	use_power = 0
	},
/turf/open/floor/mineral/titanium/white,
/area/shuttle/escape)

(1,1,1) = {"
a
t
b
b
b
t
b
b
b
t
a
"}
(2,1,1) = {"
W
t
p
p
p
t
p
p
p
t
X
"}
(3,1,1) = {"
c
t
q
v
q
t
H
H
H
t
Y
"}
(4,1,1) = {"
t
t
Z
n
R
t
T
J
j
t
t
"}
(5,1,1) = {"
t
t
t
w
f
t
f
K
t
t
t
"}
(6,1,1) = {"
a
t
s
r
s
i
s
r
s
t
a
"}
(7,1,1) = {"
a
m
s
r
s
s
s
r
s
m
a
"}
(8,1,1) = {"
t
t
s
Q
t
m
t
V
s
t
t
"}
(9,1,1) = {"
g
r
r
r
r
r
r
r
r
r
g
"}
(10,1,1) = {"
h
r
r
r
r
r
r
r
r
r
g
"}
(11,1,1) = {"
t
t
s
s
o
r
o
s
s
t
t
"}
(12,1,1) = {"
a
m
s
s
s
r
s
s
s
m
a
"}
(13,1,1) = {"
a
m
s
s
s
r
s
s
s
m
a
"}
(14,1,1) = {"
a
t
t
s
S
r
S
s
t
t
a
"}
(15,1,1) = {"
a
t
t
m
t
E
f
m
t
t
a
"}
(16,1,1) = {"
a
a
m
y
A
F
A
L
m
a
a
"}
(17,1,1) = {"
a
a
t
t
u
A
D
t
t
a
a
"}
(18,1,1) = {"
a
a
a
m
B
G
I
m
a
a
a
"}
(19,1,1) = {"
a
a
a
t
m
m
m
t
a
a
a
"}
