//MAP CONVERTED BY dmm2tgm.py THIS HEADER COMMENT PREVENTS RECONVERSION, DO NOT REMOVE
"a" = (
/turf/template_noop,
/area/template_noop)
"b" = (
/obj/structure/shuttle/engine/propulsion{
	dir = 4
	},
/turf/closed/wall/mineral/titanium/shuttle,
/area/shuttle/transport)
"e" = (
/obj/effect/spawner/structure/window/reinforced/shuttle,
/turf/open/floor/plating,
/area/shuttle/transport)
"g" = (
/turf/closed/wall/mineral/titanium/shuttle,
/area/shuttle/transport)
"h" = (
/obj/structure/chair/comfy/shuttle{
	dir = 4
	},
/turf/open/floor/mineral/titanium/blue,
/area/shuttle/transport)
"i" = (
/obj/machinery/computer/shuttle/ferry/request{
	dir = 8
	},
/turf/open/floor/mineral/titanium/blue,
/area/shuttle/transport)
"j" = (
/obj/structure/chair/comfy/shuttle,
/turf/open/floor/mineral/titanium/blue,
/area/shuttle/transport)
"k" = (
/obj/machinery/door/airlock/titanium,
/turf/open/floor/mineral/titanium/blue,
/area/shuttle/transport)
"l" = (
/turf/open/floor/mineral/titanium/blue,
/area/shuttle/transport)
"m" = (
/obj/machinery/door/airlock/titanium,
/obj/docking_port/mobile{
	dir = 8;
	dwidth = 2;
	height = 12;
	id = "ferry";
	name = "ferry shuttle";
	port_direction = 2;
	width = 5
	},
/turf/open/floor/mineral/titanium/blue,
/area/shuttle/transport)
"p" = (
/obj/structure/closet/crate,
/turf/open/floor/mineral/titanium/blue,
/area/shuttle/transport)
"q" = (
/obj/structure/chair/comfy/shuttle{
	dir = 1
	},
/turf/open/floor/mineral/titanium/blue,
/area/shuttle/transport)

(1,1,1) = {"
a
b
k
b
a
"}
(2,1,1) = {"
b
g
l
g
b
"}
(3,1,1) = {"
g
h
l
p
g
"}
(4,1,1) = {"
g
i
l
p
g
"}
(5,1,1) = {"
e
j
l
q
e
"}
(6,1,1) = {"
g
j
l
q
g
"}
(7,1,1) = {"
g
j
l
q
g
"}
(8,1,1) = {"
g
j
l
q
g
"}
(9,1,1) = {"
e
j
l
q
e
"}
(10,1,1) = {"
g
j
l
q
g
"}
(11,1,1) = {"
g
j
l
q
g
"}
(12,1,1) = {"
g
e
m
e
g
"}
